###################
# @         .#   .#
########     #   ##
#  $#   #  #    ###
# $## $   $   #  ##
######    ##     ##
#         #####  .#
#  $  ## ##########
#####     #  $   .#
##.    #######.   #
###################