####################
#  ##   ###  ##. @##
# $##$  #  $ ##   ##
#  #   ## #     ####
#  #  ##     #    ##
#         #       .#
########  $ ##### ##
######. ##  #  ##  #
##        ##       #
######  .      #####
######  ############