    ######
    ##   #
    ##$ $#
  ####   ##
  ##  $ $ #
#### # ## #   ######
##   # ## #####  ..#
## $  $          ..#
###### ### #@##  ..#
    ##     #########
    ########